0xb0xd0x30x90x50x10x30x90x50x50x30x90x50x50x50x10x70x90x10x7
0xc0x30x80x60x90x60xa0xa0x90x70xc0x60x90x50x30xa0x90x60xc0x3
0xb0xa0xa0x90x60xd0x40x60xa0x90x30x90x20xd0x60xa0xc0x30x90x2
0x80x60xa0xc0x50x50x30xb0x80x60xc0x60xc0x30x90x60xb0xa0xa0xe
0xc0x30xc0x50x30x90x60xc0x40x50x50x50x30xc0x40x50x60xa0xc0x3
0xb0xa0xd0x50x60xc0x50x50x30x90x30xd0x60x90x50x50x30xc0x30xa
0x80x60x90x50x30x90x50x30xa0xa0xc0x50x50x40x50x30xa0x90x60xa
0xa0x90x60xb0xa0xa0xf0xa0xa0xa0xf0xf0xf0x90x30xe0xc0x40x70xa
0xa0xa0xb0x80x40x60xf0xc0x60x80x50x70xf0xa0xc0x30x90x50x50x2
0xa0xa0xc0x60x90x30xf0xf0xf0xa0xf0xf0xf0xa0xd0x40x60xb0x90x6
0xa0xc0x50x50x60xc0x10x30xf0xa0xf0xd0x50x00x50x50x30xa0xc0x3
0xc0x50x50x30x90x30xa0xa0xf0xa0xf0xf0xf0xc0x70x90x60xc0x50x6
0x90x70x90x60xa0xa0xe0xa0x90x60x90x50x50x50x30x80x50x50x50x3
0xc0x30xa0x90x60xc0x30xa0xc0x30xa0xb0x90x50x60x80x50x50x30xa
0x90x60xa0x80x50x30xc0x40x70xa0xa0xa0xa0x90x30xa0x90x30xe0xa
0xa0x90x60xc0x30xa0x90x50x50x60xa0xa0xa0xa0xe0xa0xa0xa0x90x2
0x80x60xd0x50x60xa0xa0xd0x10x30xa0xa0xa0xc0x10x60xa0xc0x60xa
0xc0x50x30x90x50x60xa0x90x60xe0xa0xc0x40x30x80x70xa0x90x30xa
0x90x70xa0xc0x50x50x40x60x90x30xc0x30x90x60xe0x90x60xa0xe0xa
0xc0x50x40x50x50x50x50x50x60xc0x50x60xc0x50x50x60xd0x40x50x6

0,0
19,19
SESSWSESSWSSSSSEEESWSSSWSWSEESSEEEEEENESEENWNNNNNNEEEESWWSSSSESWSEEENENNNNESSENESSSS
