0xb0xd0x10x50x50x50x30x90x10x50x30x90x10x30xd0x50x10x30x90x3
0xc0x30xc0x50x30x90x60xa0xa0x90x60xe0xa0xa0x90x30xa0xc0x60xa
0x90x60x90x50x60xa0x90x60xa0xc0x50x30xa0xc0x60xa0xa0x90x50x2
0xc0x50x60xd0x30xa0xe0x90x60x90x30xa0xc0x30xb0xa0xa0xc0x30xe
0x90x70x90x10x60xc0x30x80x30xe0xa0xc0x50x60x80x60x80x70xc0x3
0xa0x90x60xa0x90x50x60xa0xa0x90x40x70x90x30xa0xb0xa0x90x30xa
0x80x60xb0xa0xc0x30xd0x20xa0xc0x50x50x60xa0xa0xc0x60xa0xa0xa
0xa0xd0x20xc0x30xa0xf0xa0xc0x30xf0xf0xf0xa0xc0x50x50x60xa0xa
0xc0x50x40x30xc0x60xf0xc0x70x80x50x70xf0xc0x50x10x50x70xc0x2
0x90x50x30xa0xd0x30xf0xf0xf0xa0xf0xf0xf0x90x30xa0x90x50x50x6
0xa0xb0xa0xa0x90x40x30xb0xf0xa0xf0xd0x50x20xc0x60xc0x50x50x3
0xc0x20xa0xa0xa0xd0x20xa0xf0xa0xf0xf0xf0x80x50x50x50x50x30xa
0xb0xa0xc0x60x80x30xc0x60x90x20x90x50x30xe0x90x50x50x30xa0xa
0xa0xa0xb0x90x60xc0x30x90x60xc0x40x30xc0x30xa0x90x30xa0xc0x2
0xa0xa0xc0x20x90x70xc0x60x90x30xb0xa0x90x60xc0x60xa0xc0x30xe
0xa0xc0x30xa0xc0x30x90x50x60xa0xc0x20xc0x10x10x70x80x70xc0x3
0x80x30xa0xc0x30xa0xc0x30xb0xc0x30xa0xb0xa0xe0x90x60x90x50x2
0xa0xe0xa0xb0xa0xa0x90x60x80x50x60xc0x60x80x50x60x90x60x90x6
0x80x30xa0xc0x40x60xc0x30xc0x50x50x50x30xe0x90x50x60xb0xc0x3
0xe0xc0x40x50x50x50x50x60xd0x50x50x50x40x50x60xd0x50x40x50x6

0,0
19,19
SESWSEENEENWWNEEEESWSSSESWWSESSWNWNNNWSWSWSSEEESSSSWNNNWWSSESSSSESSSSEEEEENWNENWNEENESSESWWSEEEESEENEENENEESWSES
